#########.#######
#...............#
#.###G###.#D###.#
#.#K..#P..#....G#
#.#.#.#.###.###.#
#G#.#P#.D.#.#...#
#.#D#####.#.#.###
#.#.G...#P#.#K#.#
#.###.#####.###.#
#..K#....##....K#
#.#.###.###.#####
#.#..G....#.#...#
#.#######.#.#.#D#
#.D....K#.#..G#.#
#.#.#####D#####.#
#P#..D.......D..#
#########A#######